S...................
.#########.########.
.#.................#
.#.###############.#
.#.#.............#.#
.#.#.#####.#####.#.#
.#.#.#.........#.#.#
.#.#.#.#######.#.#.#
.#.#.#.#.....#.#.#.#
.#.#.#.#.###.#.#.#.#
.#...#.#.#G#.#.#.#.#
.#.#.#.#.#.#.#.#.#.#
.#.#.#.#...#...#.#.#
.#.#.#######.###.#.#
.#.#...........#...#
.#.#######.#####.#.#
.#...............#.#
.#################.#
...................#
####################