. . . . G
# # . # #
. . . . .
# # . # #
S . . . .